%%%%%%%%%%%%%%%%%%%%%%%%%%%%%%
%       % % %                %
%       % %    %%%%%%%%%%%   %
%      %    P      %%%   %   %
%%%%% %     %%%%%% %%% % % %%%
%   % % % %    % %       %   %
%                            %
%       %     %%     % % %   %
%%%                         %%
% %           %%     %       %
% % %%%%% % %%%% % %%% %%% % %
%         %      % %   % %%% %
%.   % %%%%%      % %%% %    %
%%%%%%%%%%%%%%%%%%%%%%%%%%%%%%